,Gene,Product,Start,End,Length
0,ORF1AB,ORF1AB POLYPROTEIN,250,21537,21287
1,S,SPIKE GLYCOPROTEIN,21544,25354,3810
2,NS3,NONSTRUCTURAL PROTEIN NS3,25362,26190,828
3,E,ENVELOPE PROTEIN,26214,26442,228
4,M,MEMBRANE PROTEIN,26492,27158,666
5,NS6,NONSTRUCTURAL PROTEIN NS6,27168,27354,186
6,NS7A,NONSTRUCTURAL PROTEIN NS7A,27359,27725,366
7,NS7B,NONSTRUCTURAL PROTEIN NS7B,27721,27853,132
8,NS8,NONSTRUCTURAL PROTEIN NS8,27859,28225,366
9,N,NUCLEOCAPSID PROTEIN,28239,29499,1260
